12
1,7,5,5,5,5,5,5,5,5,5,6
3,13,7,7,5,5,5,7,5,5,6,10
10,2,9,14,3,5,6,9,5,6,10,10
10,11,7,13,14,2,9,5,6,10,10,10
10,10,11,6,9,13,5,6,10,10,10,10
10,10,9,15,6,3,6,10,10,10,10,10
10,11,5,12,10,9,14,8,10,10,10,10
10,10,3,7,15,6,10,3,12,10,10,10
10,10,11,15,15,14,10,10,3,14,10,10
10,9,13,13,13,12,10,10,9,12,8,10
11,5,5,5,5,4,10,9,5,5,6,10
9,5,5,5,5,5,13,5,5,5,12,8
